1
10 10
####################
##--------------GG##
##----------------##
##-----------PP---##
##------########--##
##--####----------##
######------------##
##----------------##
##----------------##
####################
