2
10 10
####################
##BE------------PP##
##----------------##
##----------------##
##----------------##
##----------------##
##----------------##
##----------------##
##--------------GG##
####################
(1,1) 1